11111111111111111111111111111111111111111
10000P00000000000011111111111111111111111
11111111111111111011111111111111111111111
11111111111111111011111111111111111111111
11111111111111111011111111111111111111111
10000000000011111011111111111111111111111
11111111111011111011111111111111111111111
11111111111011111011111111111111111111111
11111111111011111011111111111111111111111
10000011111011111011111111111111111111111
11111011111011111011111111111111111111111
11111011111011111011111111111111111111111
11111011111011111011111111111111111111111
100000CCCCCCCCCCCCCCCCCCCCCCCCCCCCCCCCCE1
11011111011111011111111111111111111111111
10011111011111011111111111111111111111111
11111111011111011111111111111111111111111
11111111011111011111111111111111111111111
11111111011111011111111111111111111111111
10000000011111011111111111111111111111111
11111111111111011111111111111111111111111
11111111111111011111111111111111111111111
11111111111111011111111111111111111111111
10000000000000011111111111111111111111111
11111111111111111111111111111111111111111
11111111111111111111111111111111111111111
11111111111111111111111111111111111111111
