1111111111111
1E000100000C1
1010101C10101
1010101C101b1
1P00000C000C1
1111111111111
